###########
#     # # #
### # # # #
# # #     #
# ### ### #
#     #   #
# ### # # #
# #   # # #
# # # ### #
# # # #   #
###########